...###..........#
..##.#.####.....#
.##..###..#.....#
##........#.....#
#...@..#..#.....#
###..###..#.....#
..#..#....#.....#
.##.##.#.##.....#
.#......##......#
.#.....##.......#
.######.........#
....#######.....#
....##..........#
................#
................#
#################
