############
#..........#
#......@...#
###.##.#...#
#...#..#...#
#..#......##
#...##.....#
#..........#
############
